32 35
25 15 25 13 15 13 18 15 13 17 18 17 15 13
0 0 0 0 0 0 0 0 0 0 0 0 0 0 0 0 0 0 0 0 0 0 0 0 0 0 0 0 0 0 0 0
0 0 0 0 0 0 0 0 0 0 0 0 0 0 0 0 0 0 0 0 0 0 0 0 0 0 0 0 0 0 0 0
0 0 1 1 1 1 1 1 1 1 1 1 1 1 1 1 1 1 1 1 1 1 1 1 1 1 1 1 1 1 0 0
0 0 1 3 3 3 3 3 3 3 3 3 3 3 3 1 1 3 3 3 3 3 3 3 3 3 3 3 3 1 0 0
0 0 1 3 1 1 1 1 3 1 1 1 1 1 3 1 1 3 1 1 1 1 1 3 1 1 1 1 3 1 0 0
0 0 1 4 1 1 1 1 3 1 1 1 1 1 3 1 1 3 1 1 1 1 1 3 1 1 1 1 4 1 0 0
0 0 1 3 1 1 1 1 3 1 1 1 1 1 3 1 1 3 1 1 1 1 1 3 1 1 1 1 3 1 0 0
0 0 1 3 3 3 3 3 3 3 3 3 3 3 3 3 3 3 3 3 3 3 3 3 3 3 3 3 3 1 0 0
0 0 1 3 1 1 1 1 3 1 1 3 1 1 1 1 1 1 1 1 3 1 1 3 1 1 1 1 3 1 0 0
0 0 1 3 1 1 1 1 3 1 1 3 1 1 1 1 1 1 1 1 3 1 1 3 1 1 1 1 3 1 0 0
0 0 1 3 3 3 3 3 3 1 1 3 3 3 3 1 1 3 3 3 3 1 1 3 3 3 3 3 3 1 0 0
0 0 1 1 1 1 1 1 3 1 1 1 1 1 3 1 1 3 1 1 1 1 1 3 1 1 1 1 1 1 0 0
0 0 0 0 0 0 0 1 3 1 1 1 1 1 3 1 1 3 1 1 1 1 1 3 1 0 0 0 0 0 0 0
0 0 0 0 0 0 0 1 3 1 1 3 3 3 3 3 3 3 3 3 3 1 1 3 1 0 0 0 0 0 0 0
0 0 0 0 0 0 0 1 3 1 1 3 1 1 1 2 2 1 1 1 3 1 1 3 1 0 0 0 0 0 0 0
0 0 0 0 0 0 0 1 3 1 1 3 1 5 5 5 5 5 5 1 3 1 1 3 1 0 0 0 0 0 0 0
0 0 0 0 0 0 0 1 3 3 3 3 1 5 5 5 5 5 5 1 3 3 3 3 1 0 0 0 0 0 0 0
0 0 0 0 0 0 0 1 3 1 1 3 1 5 5 5 5 5 5 1 3 1 1 3 1 0 0 0 0 0 0 0
0 0 0 0 0 0 0 1 3 1 1 3 1 1 1 1 1 1 1 1 3 1 1 3 1 0 0 0 0 0 0 0
0 0 0 0 0 0 0 1 3 1 1 3 3 3 3 3 3 3 3 3 3 1 1 3 1 0 0 0 0 0 0 0
0 0 0 0 0 0 0 1 3 1 1 3 1 1 1 1 1 1 1 1 3 1 1 3 1 0 0 0 0 0 0 0
0 0 1 1 1 1 1 1 3 1 1 3 1 1 1 1 1 1 1 1 3 1 1 3 1 1 1 1 1 1 0 0
0 0 1 3 3 3 3 3 3 3 3 3 3 3 3 1 1 3 3 3 3 3 3 3 3 3 3 3 3 1 0 0
0 0 1 3 1 1 1 1 3 1 1 1 1 1 3 1 1 3 1 1 1 1 1 3 1 1 1 1 3 1 0 0
0 0 1 3 1 1 1 1 3 1 1 1 1 1 3 1 1 3 1 1 1 1 1 3 1 1 1 1 3 1 0 0
0 0 1 4 3 3 1 1 3 3 3 3 3 3 3 3 3 3 3 3 3 3 3 3 1 1 3 3 4 1 0 0
0 0 1 1 1 3 1 1 3 1 1 3 1 1 1 1 1 1 1 1 3 1 1 3 1 1 3 1 1 1 0 0
0 0 1 1 1 3 1 1 3 1 1 3 1 1 1 1 1 1 1 1 3 1 1 3 1 1 3 1 1 1 0 0
0 0 1 3 3 3 3 3 3 1 1 3 3 3 3 1 1 3 3 3 3 1 1 3 3 3 3 3 3 1 0 0
0 0 1 3 1 1 1 1 1 1 1 1 1 1 3 1 1 3 1 1 1 1 1 1 1 1 1 1 3 1 0 0
0 0 1 3 1 1 1 1 1 1 1 1 1 1 3 1 1 3 1 1 1 1 1 1 1 1 1 1 3 1 0 0
0 0 1 3 3 3 3 3 3 3 3 3 3 3 3 3 3 3 3 3 3 3 3 3 3 3 3 3 3 1 0 0
0 0 1 1 1 1 1 1 1 1 1 1 1 1 1 1 1 1 1 1 1 1 1 1 1 1 1 1 1 1 0 0
0 0 0 0 0 0 0 0 0 0 0 0 0 0 0 0 0 0 0 0 0 0 0 0 0 0 0 0 0 0 0 0
0 0 0 0 0 0 0 0 0 0 0 0 0 0 0 0 0 0 0 0 0 0 0 0 0 0 0 0 0 0 0 0